


              
s              s
x              x
x              x
x              x
x              x
x       l      x
xxxxxxxxxxxxxxxx
  xxxxxxxxxxxxxxx
